#########
#       #
# $$$$$ #
#   $   #
#  ###  #
#  ... ##
#  ###  #
## ...  #
#  ###  #
#  ... ##
#  ###  #
## ...  #
#  ###  #
#   $   #
# $$$$$ #
#   @   #
#########
